....................
....................
....................
....................
....................
..~~~~~~~~~~~~~~~~..
..~~~~~~~~~~~~~~~~..
..~~~~#~~~~~~~~~~~..
..~~~~~~~~~~~~~~~~..
##~~~~~~~~~~~~~~~~##
..~~~~~~~~~~~~~~~~..
..~~~~~~~~~~~~~~~~..
..~~~~~~~~~~#~~~~~..
..~~~~~~~~~~~~~~~~..
..~~~~~~~~~~~~~~~~..
....................
....................
....................
....................
....................
